NO textures/wall_1.xpm




WE  textures/wall_3.xpm    

             EA                    textures/wall_4.xpm

F 90,90,90
   SO textures/wall_2.xpm
C  0, 255,                                  0

11111111111 1111111111111111111111111111111
1000001001    1000000000001110000000000000111111
10000000001111111111111111111111111111111111
 10000000000011000000000000000000111111111
1000000000000000000000000000000000000001111111
1000000000000000000000000000000000000001
100000000000000000000000000000000000001
1000000000000000001010000000000000000001
1000000000000000001N1001000000000000000111111
1000000000000000001110010000000000000001
100000000000000000000000000000000000000111111
1000000000000000000000000000000000000001
100000011111000000000000000000000000001111
100000001  1100000000000000000000000000001
10000001   110000000000000000000000000001
111111111 1111111111111111111111111111111