


NO textures/wall_1.xpm
   SO textures/wall_2.xpm


WE  textures/wall_3.xpm    
     FE 255,    0,0      

EA textures/wall_4.xpm

 C    4   ,    30    ,    0

111111111
101001001
1000W0001
111110011
111111111
