NO textures/wall_1.xpm
   SO textures/wall_2.xpm


WE  textures/wall_3.xpm    

EA textures/wall_4.xpm

F 90,90,90
C 0,0,0

 11111111111 111111111111111111111111111111
10000000001    1000000000001110000000000000111111
100000000011  1111111111111111111111111111111
 10000000000011000000000000000000111111111
1000000000000000000000000000000000000001111111
1000000000000000000000000000000000000001
1000000000000000000010000000000000000001
1000000000000000001010000000000000000001
1000000000000000001N1001000000000000000111111
1000000000000000001110010000000000000001
100000000000000000000000000000000000000111111
1000000000000000000000000000000000000001
1000000000000000000000000000000000000001
1000000000000000000000000000000000000001
1000000000000000000000000000000000000001
1111111111111111111111111111111111111111